11111111110111
10C0R01R000001
10001000100001
10P01C10C0E001
11111111111111
111