11111111111111
10C0R01R0000E1
10001000100001
10P01C10C00001
10001000100001
10001000100001
10001000100001
10001000100001
10001000100001
10001000100001
10001000100001
11111111111111