1111111111111111111111111111111111111111
10C0R01R000000000000000000000000000000E1
1000100010000000000000000000C00000000001
10P01C10C0000000000000000000000000000001
1000100010000000000000000000C00000000001
1000100010000000000000000000C00000000001
1000100010000000000000000000C00000000001
1000100010000000000000000000C00000000001
1000100010000000000000000000C00000000001
1000100010000000000000000000C00000000001
1000100010000000000000000000C00000000001
1111111111111111111111111111111111111111