10 5
1 1 1 1 1 1 1 1 1 1
1 0 C 0 R 0 1 R E 1
1 0 0 0 1 0 0 0 1 1
1 0 P 0 1 C 1 0 C 1
1 1 1 1 1 1 1 1 1 1